적 캐릭터수 : 3
적 캐릭터가 출현할 위치 개수 : 3
3 1
16 6
1 11
보스 초기 위치 : 12 16
플레이어 초기 위치 : 11 14
적 캐릭터 종류 개수 : 2
생명력: 2 이동시간 간격: 2000 미사일: 150
생명력: 3 이동시간 간격: 2500 미사일: 160
타입인덱스: 0 적캐릭터 생성 인덱스: 2 출현 시간: 1000
타입인덱스: 1 적캐릭터 생성 인덱스: 0 출현 시간: 2000
타입인덱스: 0 적캐릭터 생성 인덱스: 1 출현 시간: 3000
2 2 2 2 2 2 2 2 2 2 2 2 2 2 2 2 2 2 2 2 2 2 2 
2 0 0 3 0 0 1 0 0 0 0 0 2 0 0 0 0 0 0 0 0 0 2 
2 0 0 0 0 0 1 0 0 0 0 0 2 0 0 0 0 0 0 0 0 0 2 
2 2 2 0 0 0 0 0 0 0 0 0 2 0 0 0 1 1 1 0 0 0 2 
2 0 0 0 0 0 0 0 0 0 0 0 2 0 0 0 1 1 1 0 0 0 2 
2 0 0 0 0 0 0 0 0 0 0 2 2 2 0 0 0 0 0 0 0 0 2 
2 1 1 0 0 0 2 0 0 0 0 0 0 0 0 0 3 0 0 0 0 0 2 
2 0 0 0 0 0 2 1 1 0 0 0 0 0 0 0 0 0 0 0 0 0 2 
2 0 0 0 0 0 2 0 0 0 0 0 0 2 2 0 0 0 0 0 0 0 2 
2 0 0 0 0 0 2 0 0 0 0 0 0 2 2 0 0 0 0 2 2 2 2 
2 2 2 2 2 2 2 0 0 0 0 0 0 0 0 0 0 0 0 0 0 0 2 
2 3 0 0 0 0 0 0 0 0 0 0 0 0 0 0 0 0 0 0 0 0 2 
2 0 0 0 0 0 0 0 1 1 0 0 2 0 0 0 0 0 0 0 0 0 2 
2 0 0 0 1 1 0 0 0 0 0 0 0 0 0 0 1 1 0 0 0 0 2 
2 0 0 0 1 1 0 0 0 0 0 5 0 0 0 0 1 1 0 0 0 0 2 
2 0 0 0 0 0 0 0 0 0 0 1 1 1 0 0 0 0 0 0 0 0 2 
2 0 0 0 0 0 0 0 0 0 0 1 4 1 0 0 0 0 0 0 0 0 2 
2 2 2 2 2 2 2 2 2 2 2 2 2 2 2 2 2 2 2 2 2 2 2 
